{
  "ground": [
    [11,11,9,9,9,9,9,9,9,9],
    [10,8,8,8,8,8,8,8,8,9],
    [9,8,8,8,8,8,8,8,8,9],
    [9,8,8,8,8,8,8,8,8,9],
    [9,8,8,8,9,9,8,8,8,9],
    [9,8,8,8,9,9,8,8,8,9],
    [9,8,8,8,8,8,8,8,8,9],
    [9,8,8,8,8,8,8,8,8,9],
    [9,8,8,8,8,8,8,8,8,9],
    [9,9,9,9,9,9,9,9,9,9]
  ],
  "height": [
    [10,1,1,1,1,1,1,1,1,2],
    [1,0,0,0,0,0,0,0,0,1],
    [1,0,0,0,0,0,0,0,0,1],
    [1,0,0,0,0,0,0,0,0,1],
    [1,0,0,0,1,1,0,0,0,1],
    [1,0,0,0,1,1,0,0,0,1],
    [1,0,0,0,0,0,0,0,0,1],
    [1,0,0,0,0,0,0,0,0,1],
    [1,0,0,0,0,0,0,0,0,1],
    [2,1,1,1,1,1,1,1,1,2]
  ]
}
